....................
....................
....................
....................
....................
....................
....................
....................
.....Y..............
...BBBB..BB...BB....
....................
.................BB.
.P...........Y..T...
AAAAAAAAAAAAAAAAAAA.
....................
....................
....................
.................T..
.................BBB
....................
............Y.......
...........BBB......
.....Y..............
...BBBB.............
....................
....................
....................
.AAAAAAAAAAAAAAAAAA.
.
.
.
.
.
.
.
.
.
...FG...FG...FG...FG...FG...FG...FG....FG...FG...FG...FG...FG...
...HI...HI...HI...HI...HI...HI...HI....HI...HI...HI...HI...HI...
...HI...HI...HI...HI...HI...HI...HI....HI...HI...HI...HI...HI...
...HI...HI...HI...HI...HI...HI...HI....HI...HI...HI...HI...HI...
AAAAAAAAAAAAAAAAAAAAAAAAAAAAAAAAAAAAAAAAAAAAAAAAAAAAAAAAAAAAAAAAAAAAAAAA