....................
....................
....................
....................
....................
....................
............Y.......
...........BBB......
.....Y..............
...BBBB.............
....................
....................
....................
AAAAAAAAAAAAAAAAAAA.
....................
....................
....................
....................
....................
....................
............Y.......
...........BBB......
.....Y..............
...BBBB.............
....................
....................
.P..................
.AAAAAAAAAAAAAAAAAA.
.
.
.
.
.
.
.
.
.
...FG...FG...FG...FG...FG...FG...FG....FG...FG...FG...FG...FG...
...HI...HI...HI...HI...HI...HI...HI....HI...HI...HI...HI...HI...
...HI...HI...HI...HI...HI...HI...HI....HI...HI...HI...HI...HI...
...HI...HI...HI...HI...HI...HI...HI....HI...HI...HI...HI...HI...
AAAAAAAAAAAAAAAAAAAAAAAAAAAAAAAAAAAAAAAAAAAAAAAAAAAAAAAAAAAAAAAAAAAAAAAA